1111111111
1310110121
0000100001
1010010101
0001000101
1101101000
0000100110
1010001001
1100100001
0001001101