1111111111
1310110121
0000100001
1010010101
0001000101
1101101000
0000100110
1010001001
1100100001
0001001101
0100101011
1101110001
1101110111
0001000101
0101010101
0000000000
1110110111
1100110011
1101111011
1100110011
0000100001
1010010101
0001000101
1101101000
0000100110
1010001001
1100100001
0001001101
0100101011
1100110001